.~..............
.#..............
....<__>........
<>..>...<__>....
................
~~~~~~~~~~~~~~~~
################
################